# Copyright Notice:  Al Jones 2005 - 2015
# License: This file in its original form may be distributed freely.
# of this file may not be distributed or published by any means.
# This file may be modified for personal use only; any modified version
# of this file may not be distributed or published by any means.
#
# The structure of the file is:
# Field 1: the Vendor ID 
# Field 2: the Company / Foundry using the ID
# Field 3: the Designer using the ID
#
# I'd like to remind you all that FontOrg is a shareware program.
# It takes a considerable amount of time to update it and its associated files.
# If you find yourself using it on a regular basis I'd appreciate you tipping
# something into my PayPal Account.  The link to it can be found at FontOrg.us
# Thanks //al
#
 .0 	Cosmonaut Fonts
FOO	_FOO
SWAP	_SWAP	
TAKE	_TAKE
!!!!	Financial Peril Publishing & Design	Allen Zuk
!22!	22 Software
!ETF 	!Exclamachine Type Foundry
#MACR 	Macromedia / Made with Fontographer
$pro 	CheapProFonts
021	JW Type	Johan W
13th	13th Degree	Zane Townsend
#1ASC 	Ascender Corporation
1BOU 	Boutros International
2DLT 	2D Typo
2REB 	2 Rebels
2TTF	2TTF Gallery
39BC 	Finley's Barcode Fonts
3ip 	Three Islands Press
4FEB 	4th february
5PTS 	Five Points Technology
918 	RavenType
A&S 	Art & Sign Studio
A2 	A2-Type
A2HK	A2-Type	Henrik Kubel
A60	AlphaType	Joseph Miceli
aaff 	AstroAcademia Font Foundry
ABBO 	Arabic Dictionary Lab
ABC 	Altek Instruments
abcd		Carolina Trebol
ABOU 	Aboutype
ACG	Agfa
ACUT 	Acute Type
ADBE 	Adobe
ADFP	Arkandis Digital Foundry	Harendal Hirwen
ADSK	Autodesk
ADG 	Apply Design Group
AEF 	Altered Ego Fonts
AERO	Aerotype
aff		Christoph Dunst
AGFA 	Monotype Imaging
agt	AGT
AID 	Artistic Imposter Design
akaT	AKA Type
AKOF 	AKOFAType
ALFA 	Alphabets
ALPH 	Alphameric Broadcast Solutions Limited
ALPN 	Alpona Portal
ALS 	Art Lebedev Studio
alte 	Altemus
AMT	Monotype Imaging
AMUT 		Kwesi Amuti
ANDI	Andinistas	Carlos Fabian Camargo
ANDO 		Osam Ando
anty 	Anatoletype
AOE	Astigmatic One Eye	Brian J Bonislawsky
AOEF	Astigmatic One Eye	Brian J Bonislawsky
AOP 	an Art Of Pengwyn
APLY 	Apply Interactive
APOS 	Apostrophic Laboratories
APPL 	Apple
ARBX 	Arabetics
ARCH 	Architext
ARPH 	Arphic Technology Co.
ARS 	EN ARS Ltd.
ArsC	Arsenal
ArTy 	Archive Type
ASFT	ingoFont
ASL 	Abneil Software Ltd fonts
ASSA 	astype
ASTF	Alphabet Soup Type	Michael Doret
ASYM 	Applied Symbols
ATEC 	Page Technology Marketing
ATF1 	Australian Type Foundry
ATFS 	Andrew Tyler's fonts
ATRA	atrax
AURE 	Aure Font Design
AUTO 	Autodidakt
AVP 	Aviation Partners
ayff	a la naga
AZLS 	Azalea Software
B&H 	Bigelow & Holmes
BARS 	CIA (BAR CODES) UK
BASE 	Baseline Font Foundry
BAT 	BUREAU DES AFFAIRES TYPOGRAPHIQUES
BC	VNBC	Benoit Champy
BCP 	Barcode Products Ltd
BDTD	Buro Destruct
BERG	NuevoDeco Typography	David Bergsland
BERT 	Berthold
BITM 	Bitmap Software
BITS 	Bitstream
bizf 	Bizfonts.com
BKM	BoKoMa CM Fonts
BLAB 	BaseLab
BLAH 	Mister Bla's Fontworx
BLI 	Blissym Language Institute
BLL		Billy Argel
BMON	Bold Monday
BOLD 	Bold Monday
BORW 	em2 Solutions
BOYB 	BoyBeaver Fonts
BPGI	BPG InfoTech
BREM 	Mark Bremmer
BROS 	Michael Brosnan
BRTC 	ITSCO - Bar Code Fonts
BS 	Barcodesoft
BSPK	Village Type & Design
BUBU 	BUBULogix
BWFW 	B/W Fontworks
C&C 	Carter & Cone
C21 	Club 21
CAK 	pluginfonts.com
CANO 	Canon
CANT	Canada Type
CASL 	H.W. Caslon & Company Ltd.
CB 		Christian Buning
CBDO 	Borges Lettering & Design
CDAC 	Centre for Development of Advanced Computing
cdd 	Crazy Diamond Design
CDFP 	VT2000 Technical Services
CELB 	Celebrity Fontz
CF 	Colophon Foundry
CFA 	Computer Fonts Australia
CFF 	Characters Font Foundry	Character
CHAR	Characters Font Foundry	Character
CHR	Characters Font Foundry	Character
CJCJ 	Creative Juncture
CKTP 	CakeType
CLM 	Culmus Project
CNBO		Chan-Nguyen
COMM 	Commercial Type
CONR 	Connare.com
COOL 	Cool Fonts
CORD 	corduroy
corr		Manuel Eduardo Corradine
CPC	CybaPee Creations	Petra Heidorn
CR8 	CR8 Software Solutions
CT 	CastleType
CTDL 	China Type Designs Ltd.
CTL 	Chaitanya Type Library
cwwf 	Computers World Wide/AC Capital Funding
CYPE 	Club Type
DAMA 	Dalton Maag Limited
DB 		Daniel Bruce
DBFF 	DesignBase
DD 	Devon DeLapp
Deco 	DecoType
DELV 	Delve Fonts
dezc 	Dezcom
DFS 	Datascan Font Service Ltd
DGL 	Digital Graphic Labs foundry
DP	Dick Pape	Dick Pape
DRDN	Darden Studio
DS 	Dainippon Screen Mfg. Co.
DSBV 	Datascan bv
DSCI 	Design Science
DSGN 	DizajnDesign
DSKY 		Jacek Dziubinski
DSSR 	Dresser Johnson
DSST 		Dubina Nikolay
DST 	DSType
DT 	DecoType
DTC 	Digital Typeface Corp.
DTF 	Dunwich Type Founders
DTL 	Dutch Type Library
DTPS 	DTP-Software
dtpT 	dtpTypes Limited
DUXB 	Duxbury Systems
DYNA 	DynaLab
EDBI 	edilbiStudio
EDGE 	Rivers Edge Corp.
EF 	Elsner + Flake
EFF 	Electronic Font Foundry
EFI 	Elfring Fonts
EFNT 	E Fonts L.L.C.
EFWS 	eFilm World
ELSE 	Elseware
EMGR 	Emigre
EMT		Eduardo Manso
EPSN 	Epson
ESIG 	E-Signature
EVER 	Evertype
F25	F25 Digital Typeface	Volker Busse
FA 	FontArte Type Foundry
FAT 	Fatype
FBI 	The Font Bureau
FBRC	Font Fabric
FCAB 	The Font Cabinet
FCAN 	fontage canada
FCTP 	Facetype
FDI 	FDI fonts.info
FeoN 	Feorag NicBhrìde
FGOD 	FontGod
FJTY 		Frank Jonen
FLAT	Flat It Type Foundry
FMFO 	Studio Liddell Graphic Design
FNTF 	Fontfoundry
FoFa 	FontFabrik
FONT 	Font Source
FOUN 	The Foundry
FRML 	formlos
FS 	Formula Solutions
FSE 	Font Source Europe
FSI 	FontShop International
FSL 	FontSurfer Ltd
fsmi 	Font Smith
FTFT 	Font Font
FTGD 	Font Garden
FTH 	For the Hearts
FTN 	Fountain
FTPT 	Fontpartners
FWKS 	Fontworks
FWRE 	Fontware Limited
GALA 	Galapagos Design Group
GALO 		Gerald Gallo
GARI 		Gary Ritchie
GATF 	Greater Albion Typefounders
GD 	GD Fonts
GEM	GeM Fonts	Graham Meade
GF 	Garage Fonts
GIA 	Georgian Internet Avenue
GLCF 	GLC foundry
GLYF 	Glyph Systems
GM	GeM Fonts	Graham Meade
GM+	GeM Fonts	Graham Meade
GNU 	Free Software Foundation
GOAT 	Dingbat Dungeon
GOGO 	Fonts-A-Go-Go
GOHE 	GoHebrew
GPI 	Gamma Productions
GRIL 	Grilled cheese
GRIM 	Legacy publishing
grro 	grafikk Roren
GT 	Graphity!
GTYP 	G-Type
H&FJ 	Hoefler & Frere-Jones
HA 	HoboArt
HAD 	Hoffmann Angelic Design
HAIL 	Hail Design
hano	Hanoded Fonts	David Kerkhoff
HAUS 	TypeHaus
HCI	Human Computers
HEB 		Sivan Toledo
HFJ 	Hoefler & Frere-Jones
HIH 	HiH Retrofonts
HILL 	Hill Systems
HJZ 		Hans J. Zinken
HL 	High-Logic
HM 	Haiku Monkey
HMK	Hallmark Design Studio
HoP 	House of Pretty
HOUS 	House Industries
HP 	Hewlett-Packard
HS 	HermesSOFT Company
HTF 	The Hoefler Type Foundry
HXTP 	Hexatype
HY 	HanYang Information & Communication
IBM 	IBM
IDAU 	IDAutomation.com
IDEE 	IDEE TYPOGRAFICA
IDF 	International Digital Fonts
IKOF 	IKOffice GmbH
ILP 	Indigenous Languages Project
IMPR 	Impress
INGT 	Ingrimayne Type
INRA 	INRAY
INVC 	Invoice Central
INVD 	TYPE INVADERS
IPA	Information Promotion Agency
ISE 	ISE-Aditi Info. Pvt . Ltd.
ITC 	ITC
ITF 	Red Rooster Collection
ITFO 	Indian Type Foundry
JABM 	JAB'M Foundry
JAF 	Just Another Foundry
JAKE 	Jake Tilson Studio
JBLT 	JEAN-BAPTISTE LEVÉE TYPOGRAPHY
JDB		Jeff Bensch
JF 		Jan Fromm
JFS	Jester Font Studio	
JPTT 	Jeremy Tankard Typography	Jeremy Tankard
JRD	Splash	Jeremy Dooley
JY 	JIYUKOBO Ltd.
K22	K22 Type	Toto
KATF 	Kingsley
KDW 	Kataoka Design Works
KEVN	AsiaSoft Inc	
KF 	Karakta Fonthome
KGRP	Pixel Plant
KLIM 	Klim Typographic Design
KLTF 	Karsten Luecke
KNST 	Konst.ru
KORK 	Khork OÜ
KOVL 	Koval Type Foundry
KRKO 	Kreative Software
KRND 	Karandash Type & Graphics Foundry
KTF 	Kustomtype
KUBA 	Kuba Tatarkiewicz
LAIT 	la laiterie
LANS 	Lanston Type Company
LARA 	Larabie Fonts
LAUD 	Carolina Laudon
LAYT 	LAYOUT SARL
LDO		Luke D Owens
LEAF 	Interleaf
LETR 	Letraset
LGX 	Logix Research Institute
LHF 	Letterhead Fonts
LING 	Linguist's Software
LINO 	Linotype
LIVE 	Livedesign
LNGU 	LangusteFonts
LNTO 	Lineto
LORO 	LoRo Productions
LP 	LetterPerfect Fonts
LT 	Le Typophage
LTRX 	Lighttracks
LTTR 	LettError
LUD 	Ludlow
LuFo 	Lucas Fonts
MADT 	MADType
MAPS 	Tom Mouat's Map Symbol Fonts
MATS 	Match Fonts
MC 	Cerajewski Computer Consulting
MCKL 	MCKL
MCOW 	Mountaincow
MDSN 	Moraitis Design
MEH 		Steve Mehallo
MEIR 		Meir Sadan
MESA 	FontMesa,
MF 	Magic Fonts
MFNT 	Masterfont
MILL 	Millan
MJ 	Majus Corporation
MJR 	Majur
MK		Manfred Klein
MLBU 	Malibu Dream Designs, LLC
MLGC 	Micrologic Software
mlss 	Mark Simonson Studio
MMFT 		Michel M.
MMIK 	Monomonnik
MODI 	Modular Infotech Private Limited.
MOHT 	Al Mohtaraf Assaudi Ltd
MONB 	Monib
MONE 	Meta One Limited
MONO 	Monotype Imaging
MOON 	Moonlight Type and Technolog
MRSW 	Morisawa & Company, Ltd.
MRV 	Morovia Corporation
MS 	Microsoft Corp.
MSCR 	Majus Corporation
MSE 	MSE-iT
MT 	Monotype Imaging
MTF 	Miss Tiina Fonts
MTY 	Motoya Co
MUTF 	Murasu Systems Sdn. Bhd
MVty 	MV Typo
MYFO 	MyFonts.com
NB 	No Bodoni Typography
ncnd 	&cond
NDTC 	Neufville Digital
NEC 	NEC Corporation
NICK 	Nick's Fonts	Nick Curtis
NIS 	NIS Corporation
NORF 	Norfok Incredible Font Design
NOVA 	NOVATYPE
NSW	NSW
OHG 	Our House Graphic Design
OPTM 	Optimo
OPTO 	Opto
ORBI 	Orbit Enterprises
OURT 	Ourtype
P22 	P22 Type Foundry
PARA 	ParaType
PBTS	Pink Broccoli Types	Phil Bracco
PD 	Pangea design
PDWX 	Parsons Design Workx
PF 	Phil's Fonts
PIXL 	Pixilate
PKDD 	Philip Kelly Digital Design
PLAT 	PLATINUM technology
PLMF		Perry Mason
prch	Parachute Graphics
PRFS 	Production First Software
PRGR 	Paragraph International
PRTF 	Process Type Foundry
PSIS 	PhotoShopIsland.com
PSY 	PsyOps Type Foundry
PT 	Playtype APS
#PTF 	Porchez Typofonderie	also Process Type Foundry
PTMI 	Page Technology Marketing
PTYP 	preussTYPE
QMSI 	QMS Imagen
QRAT 	Quadrat Communications
READ 	ReadyType
REAL 	Underware
RJPS 	Reall Graphics
RKFN 	R K Fonts
RL 		Ruben Holthuijsen
RLTF 	Rebeletter Studios
RMU 	RMU TypeDesign
robo 	Buro Destruct	Petr van Blokland
RP		R A Pavlov
RRT 	Red Rooster Collection
RST 	Rosetta
RUDY 	RudynFluffy
RYOB 	Ryobi Limited
SAND 	Sandoll
SAPL 	Fonderie sans plomb
SATY 	Samuelstype Design AB
SAX 	s.a.x. Software gmbh
SBT 	SelfBuild Type Foundry
Sean 	The FontSite
SFF	Scrappin Fun Fonts
SFS 	Sarumadhu Services Pvt. Ltd.
sft		Jeffrey N Levine
sfty		Jeffrey N Levine
SFUN 	Software Union
SG 	Scooter Graphics
SHAM 	ShamFonts / Shamrock Int.
SHFT 	Shift
SHOT 	Shotype
SHUB 	The Software Hub
SIG 	vLetter, Inc
SIL 	SIL International
SIT 	Summit Information Technologies Pvt.Ltd,
SKP 	Essqué Productions
skz 	Celtic Lady's Fonts
SL 	Silesian Letters
SN 	SourceNet
SOHO 	Soft Horizons
SOS 	Standing Ovations Software
SSCF	Summitsoft Corp
STC 	Sorkin Type Co
STCH	Studio Charlie
STF 	Sooy Type Foundry	Brian Sooy
STIX	STI Pub Companies
Stor 	Storm Type Foundry
STYP 	Stone Type Foundry
SUDT	Sudtipos
SUNW 	sunwalk fontworks
SvAm	ScanVec Co
SVTD 	Synthview
SWAP	Hebrew Fonts
SWFT 	Swfte International
SXRA 	Page42 Type Foundry
SYDA 	Shree Muktananda Ashram
SYN 	SynFonts
SYRC 	Syriac Computing Institute
TBFF 	TrueBlue Font Foundry
TC 	Typeco
TDR 	Tansin A. Darcos & Co.
TERM 	Terminal Design
TF 	Treacyfaces
TF3D 	TattooFont3D
THIN 	Thinstroke Design LLC
TILD 	Tilde, SIA
TIMO 		Tim Romano
TIMR 		Tim Rolands
TIPO 	Tipo
TIRO 	Tiro Typeworks
TJS 	Typejockeys
TMF 	The MicroFoundry
TPMA 	typoma
TPSP 	Type Supply
TPTC 	Test Pilot Collective
TPTQ 	Typotheque
TR 	Type Revivals
TS 	TamilSoft Corporation
TS25	_TypeSmith Amiga
TSPC 	Typespec Ltd
TSTY 		Torleiv Georg Sverdrup
TT 	TypeTogether
TTG 	Twardoch Typography
TTT	Positype	Neil Summerour
TYCU 	TypeCulture
TYFR 	typographies.fr
TYPA 	Typadelic
TYPE 	Type Associates
TYPO 	Typodermic
TYPR 	Type Project
TYRE 	typerepublic
UA 	UnAuthorized Type
UKWN	_Unknown	_Unknown
UNDT 	UNDT
URW 	URW
UT 	Unitype Inc
VINT 	Vinterstille
VKP 		Vijay K. Patel
VLKF 	Visualogik Technology & Design
VLLG	Village Type & Design
VLNL 	VetteLetters.nl
VMT 	VMType
VNBC	VNBC	
VOG 		Martin Vogel
VROM 		Vladimir Romanov
VS 	VorSicht GmbH
VT 	VISUALTYPE SRL
WAFO	Walden Font
WASP 	Wasp Barcode Technologies
WILL 	Willerstorfer Font Foundry
Wins	WinSoft International
WL 	Writ Large Fonts
WM 	Webmakers India
XFC 	Xerox Font Services
XOTH 		Xoth Morello
Y&Y 	Y&Y
YDS 	Yellow Design Studio
YN 	Yanone
YOFF 	Your Own Font Foundry
YOKO 		Yokokaku
YOUR 	YourFonts.com
ZANE 	Unrender
ZeGr 	Zebra Font Factory
zeta 	Tangram Studio
ZKA1		Pavel Pavlov
ZSFT 	Zsoft